Variable	Variablenbeschreibung	Variablenwerte	Angabe optional / obligatory	Anmerkungen				
Bundesland	This variable lists the name of the federal state of the Federal Republic of Germany. The Federal Republic of Germany is divided into 16 federal states.	free text	obligatory					
Verantwortliches Ministerium	Die Variable Verantwortliches Ministerium This variable lists the ministry of the respective federal state that is responsible for the area of Open Access / Open Science/Digitization in that federal state.das Ministerium des jeweiligen Bundeslandes auf, welches für den Bereich Open Access / Open Science/Digitalisierung im Bundesland zuständig ist.	free text	obligatory					
Verantwortliches Ministerium: URL	This URL variable lists the link that leads to the home page of the respective ministry.	URL	obligatory					
OA im Koalitionsvertrag /Koalitionsvereinbarung	This variable describes whether OA is mentioned in the coalition agreement of the current (as of May 2021) governing coalition and retrospective coalitions in the respective federal state.	0;1	obligatory				value of variable	Description
OA im Koalitionsvertrag/Koalitionsverienbarung: URL 1	This variable shows the URL to the current (as of May 2021) coalition agreement of the respective federal state , in which Open Access is mentioned.	URL	optional				1	The value 1 is assigned if a variable is answered positively (=yes).
OA im Koalitionsvertrag/Koalitionsverienbarung: Text 1	This variable displays the text excerpt from the current coalition agreement in which OA is mentioned.	free text	optional				0	The value 0 is assigned if a variable is answered negatively (=no)
OA im Koalitionsvertrag / Koalitionsvereinbarung: URL 2	This variable displays the link to a past coalition agreement of the respective state in which OA is mentioned.	URL	optional				NA	The value NA (not available) is assigned if the search shows that no information is available. 
OA im Koalitionsvertrag/ Koalitionsverienbarung: Text 2	This variable displays the text excerpt of a past coalition agreement of the respective federal state in which OA is mentioned.	free text	optional				URL	website URL 
OA-Positionierung	This variable indicates whether each ministry has published its own strategy/policy/guideline on Open Access.	0;1	obligatory				free text	Relevant free text is taken from the mentioned source
Art der OA-Positionierung: Policy Strategie Leitlinie: Titel	This variable names the title of the respective document, in which the federal state positions itself toward Open Access.   	free text	optional					
OA-Positionierung: URL	This variable shows the URL to the document of the respective Open Access positioning of the respective federal state	URL	optional					
OA in den Hochschulgesetzen	This variable indicates whether OA is mentioned in the higher education law of the respective state.	0;1	obligatory					
OA in den Hochschulgesetzen: URL	This variable contains the URL to the higher education law of the respective state in which OA is mentioned.	URL	optional					
OA in den Hochschulgesetzen: Text	This variable shows the text excerpt from the Higher Education Act of the respective federal state in which Open Access is mentioned. If there is a page number in the cited document, it is indicated.	free text	optional					
OA in Hochschulverträgen Zielvereinbarungen	This variable indicates whether OA is specified in the respective state of a form of higher education governance.	0;1	obligatory					
OA in der Hochschulsteuerung: Titel 1. Ziel- und Leistungsvereinbarungen auf Länderebene	This variable shows the title of the respective document of the target and performance agreement at country level in which OA is mentioned.	free text	optional					
OA in der Hochschulsteuerung: URL 1	This variable shows the URL of the document of the target and performance agreement on the country level, in which Open Access is mentioned.	URL	optional					
OA in der Hochschulsteuerung: Titel 2-3. Ziel- und Leistungsvereinbarung auf Einrichtungsebene	This variable shows the titles of the respective documents of the target and performance agreements at institutional level in which OA is mentioned.	free text	optional					
OA in der Hochschulsteuerung: URL 2-3	This variable shows the URL of the respective documents of the target and performance agreements at institution level in which OA is mentioned.	URL	optional					
OA in der Hochschulsteuerung: Titel 4-6. Hochschulentwirklungsverträge und Wissenschaftspläne auf Länderebene	This variable shows the titles of the respective documents of the higher education development agreements or science plans at the state level in which OA is mentioned.	free text	optional					
OA in der Hochschulsteuerung: URL 4-6	This variable shows the URL of the respective documents of the higher education development contracts or science plans on the country level in which Open Access is mentioned.	URL	optional					
OA in der Hochschulsteuerung: Titel 7. Digitalisierungsstrategien	This variable shows the titles of the respective digital strategy documents at country level in which OA is mentioned.	free text	optional					
OA in der Hochschulsteuerung: URL 7	This variable shows the URL of the respective digital strategy documents at country level in which OA is mentioned.	URL	optional					
(Politische) Förderprogramme	This variable describes whether there is or was a political support program in the respective state.	0;1	obligatory					
(Politische) Förderprogramm 1-3: Titel	This variable designates the title of the political support program in the respective state.	free text	optional					
(Politische) Förderprogramm 1-3: URL	This variable names the website or document link to the policy support program in the state.	URL	optional					
(Politische) Förderprogramme: Finanzierung 1-3: Summe	This variable specifies the amount with which the political support program is financed in the respective state.	0;1	optional					
Landesfonds	This variable indicates whether there is funding for OA at the state level in the respective state.	free text	obligatory					
Landesfonds:  Buch; Zeitschrift; gemischt	This variable indicates the format for which this funding is valid. You can choose between book, magazine or mixed.	free text	optional					
Landesfonds: URL	This variable shows the URL to the respective web page where information about the funding can be found.	URL	optional					
Landesfonds: finanzielle Ausstattung  (Summe)	This variable shows the amount of money a country fund is endowed with.	0;1	optional					
Landesfonds: finanzielle Ausstattung: URL	This variable shows the URL to the web page where information about the financial endowment to the state fund can be found.	URL	optional					
Landesstrategien für bestimmte OA-Handlungsfelder	This variable indicates whether there are further strategies for specific fields of action in the OA field in the respective federal state.	0;1	obligatory					
Landesstrategien für bestimmte OA-Handlungsfeld 1: Name	This variable indicates the title of the state strategy that exists in the respective state for a specific field of action in OA.	free text	optional					
Landesstrategien für bestimmte OA-Handlungsfeld 1: URL	This variable specifies the URL to the website or document of the state strategy that exists in the respective state for a specific field of action in OA.	URL	optional					
Zentrale Landeseinrichtungen	This variable indicates whether there are central state institutions in the respective state that are responsible for OA.	0;1	obligatory					
Zentrale Landeseinrichtung: Titel	This variable specifies the title of the state institution responsible for OA in the respective state.	free text	optional					
Zentrale Landeseinrichtung: URL	This variable specifies the link to the website of the state institution responsible for OA in the respective state.	URL	optional					
Förderung von Infrastrukturen	This variable indicates whether the respective federal state promotes infrastructures in the area of open access.	0;1	obligatory					
Förderung von Infrastrukturen 1-3: Titel	This variable designates the title of the infrastructure supported by the respective state.	free text	optional					
Förderung von Infrastrukturen 1-3: URL	This variable designates the URL to the website with info about the infrastructure supported by the respective state.	URL	optional					
Förderung von Infratsukturen 1-3: Summe	This variable designates the sum with which the infrastructure supported by the respective federal state is financed.	0;1	optional					
OA Quoten	This variable indicates whether the respective state has set its own OA quota.	Zahl	obligatory					
Quote: Wie hoch?	This variable indicates how high the open access quota is for the respective state.	Zahl	optional					
Quote: URL	This variable specifies the URL to information about the open access quota for the respective state.	URL	optional					
Zentrales Monitoring	This variable indicates whether there is central open access monitoring in the respective state.	0;1	obligatory					
Zentrales Monitoring: URL	This variable specifies the URL to the web page or document where information on open access monitoring can be found.	URL	optional					
Incentivierung (Wettbewerbe, Preise etc.)	This variable indicates whether the state funds some form of incentive through contests, prizes, or the like for OA.	0;1	obligatory					
Incentivierung 1: Name	This variable indicates the title of the incentive program.	free text	optional					
Incentivierung 1: URL	This variable specifies the link to the web page or document that contains information about the particular incentive program.	URL	optional					
Förderung von und für Netzwerke	This variable indicates whether the respective federal state promotes networks in the area of OA.	0;1	obligatory					
Förderung von und für Netzwerke 1: Name	This variable indicates the title of the network that is supported by the respective federal state in the area of OA	free text	optional					
Förderung von und für Netzwerke 1: URL	This variable specifies the URL of the network that is supported by the respective federal state in the area of Open Access	URL	optional					
Kompetenzentwicklung	This variable indicates whether the respective federal state promotes competence centers in the area of OA.	0;1	obligatory					
Kompetenzentwicklung 1: Name	This variable indicates the title of the competence center that the respective federal state promotes in the area of OA.	free text	optional					
Kompetenzentwicklung 1: URL	This variable specifies the URL to the competence center that the respective federal state promotes in the area of OA.	URL	optional					
Arbeitsgruppen (OA-Beauftragte)	This variable indicates whether the respective federal state supports working groups, e.g. of OA officers.	0;1	obligatory					
Arbeitsgruppe 1: Name	This variable names the title of the OA working group funded by the respective state.	free text	optional					
Arbeitsgruppe 1: URL	This variable names the URL to information about the OA working group funded by the respective state.	URL	optional					
Vernetzungsformen auf Landesebene	This variable names whether there are forms of networking in the area of OA at the state level.	0;1	obligatory					
Vernetzungsformen auf Landesebene 1: Name	This variable names the title of the form of networking at the state level in the area of OA.	free text	optional					
Vernetzungsformen auf Landesebene 1: URL	This variable names the URL to the web page or document that contains information about the networking form at the state level in OA.	URL	optional					
Länderübergreifende Zusammenarbeit zur Förderung von OA	This variable indicates whether there is a cross-country form of networking in the area of Open Access, for example Open Access exchange between federal states and the BMBF.	0;1	obligatory					
Länderübergreifende Zusammenarbeit 1: Name	This variable denotes the form of cross-national exchange in the field of OA.	free text	optional					
Länderübergreifende Zusammenarbeit 1: URL	This variable specifies the URL to the web page or document where information about cross-country exchange in OA can be obtained.	URL	optional					
Assoziierte Projekte	This variable indicates whether there are projects associated with OA in the respective state.	0;1	obligatory					
Assoziiertes Projekt 1-4	This variable identifies projects associated with open access by subject area, including open source; open data; open educational resources; research data.	free text	optional					
Assoziiertes Projekt 1-4: Name	This variable names the projects associated with OA by project title in each state.	free text	optional					
Assoziiertes Projekt 1-4: URL	This variable names the URL to the web page with information about the project associated with OA in each state.	URL	optional					
Best Practices aus den Bundesländern	This variable indicates whether open access best practices exist in the state.	0;1	obligatory					
Best Practice 1-3: Name	This variable names the title of the respective best practice in OA in the respective state.	free text	optional					
Best Practice 1-3: URL	This variable names the URL to the respective best practice in OA in the respective state.	URL	optional					
Best Practice 1-3: Textauszug	Diese Variable gibt den Textauszug aus dem Länder-Dossier zur jeweiligen Best Practice im Bereich Open Access im jeweiligen Bundesland an.	free text	optional					
Politische Wahlen: Jahr	This variable designates in which year the political elections in the respective state take place or have taken place.	dd/mm/yyyy	obligatory					
Die Linke - Open Access im Parteiprogramm	This variable indicates whether The Left Party (Die Linke) names OA in its current election program.	0;1	obligatory					
Parteiprogramm Die Linke: Link	This variable names the URL to the party program of The Left Party (Die Linke) in the respective federal state.	URL	optional					
Parteiprogramm Die Linke: Textauszug	This variable specifies the text excerpt in which Open Access is named in the party program of The Left Party (Die Linke). If there is a page reference, this is also named.	free text	optional					
SPD - Open Access im Parteiprogramm	This variable indicates whether the Social Democratic Party for Germany (SPD) party names OA in its current election program.	0;1	obligatory					
Parteiprogramm SPD: URL	This variable designates the link to the party program of the SPD in the respective federal state.	URL	optional					
Parteiprogramm SPD: Textauszug	This variable specifies the text excerpt in which Open Access is named in the SPD party program. If there is a page reference, this is also named.	free text	optional					
Bündnis 90/Die Grünen - Open Access im Parteiprogramm	This variable indicates whether the Green Party (Bündnis 90/Die Grünen) names OA in its current election program.	0;1	obligatory					
Parteiprogramm Bündnis 90/Die Grünen: URL	This variable designates the link to the party program of Bündnis 90/Die Grünen in the respective federal state.	URL	optional					
Parteiprogramm Bündnis 90/Die Grünen: Textauszug	This variable specifies the text excerpt in which Open Access is mentioned in the party program of Bündnis 90/Die Grüne. If there is a page reference, this is also named.	free text	optional					
CDU - Open Access im Parteiprogramm	This variable indicates whether the Christian Democratic Union (CDU) names OA in its current election program.	0;1	obligatory					
Parteiprogramm CDU: URL	This variable designates the link to the party program of the CDU in the respective federal state.	URL	optional					
Parteiprogramm CDU: Textauszug	This variable specifies the text excerpt in which Open Access is named in the CDU party program. If there is a page reference, this is also named.	free text	optional					
FDP - Open Access im Parteiprogramm	This variable indicates whether the Free Democratic Party (FDP) party names OA in its current election program.	0;1	obligatory					
Parteiprogramm FDP: URL	This variable designates the link to the party program of the FDP in the respective federal state.	URL	optional					
Parteiprogramm FDP: Textauszug	This variable specifies the text excerpt in which Open Access is named in the party program of the FDP. If there is a page reference, this is also named.	free text	optional					
Länder-Dossier Textauszug 1: Kurzer Abriss: Historie und Stand der Aktivitäten	This variable shows the text excerpt on the topic of history and status of activities from the country dossier for the respective federal state.	free text	optional					
Länder-Dossier Textauszug 2: Rahmenbedingungen	This variable shows the text excerpt on the topic of framework conditions from the country dossier for the respective federal state.	free text	optional					
Länder-Dossier Textauszug 3: Aktivitäten und Maßnahmen zur Förderung von Open Access	This variable shows the text excerpt on the topic of activities and measures to promote OA from the state dossier for the respective federal state.	free text	optional					
Länder-Dossier Textauszug 4: Vernetzungsaktivitäten	This variable shows the text excerpt on the topic of networking activities from the country dossier for the respective federal state.	free text	optional					
Länder-Dossier Textauszug 5: Assoziierte Themen	This variable shows the text excerpt on the Associated Topics topic from the country dossier for the respective federal state.	free text	optional					